{
   "CS": {
      "CS101": 40,
      "CS102": 40,
      "CS107": 40,
      "CS108": 40
   },
   "CY": {
      "CY101": 40,
      "CY102": 40,
      "CY107": 40,
      "CY108": 40
   },
   "EE": {
      "EE108": 40,
      "EE109": 40,
      "EE114": 40,
      "EE115": 40
   },
   "LH": {
      "LH105": 120,
      "LH106": 120,
      "LH110": 600,
      "LH204": 60,
      "LH205": 60,
      "LH206": 60,
      "LH207": 60,
      "LH304": 60,
      "LH305": 60,
      "LH306": 60,
      "LH307": 60,
      "LH308": 300
   },
   "ME": {
      "ME108": 40,
      "ME109": 40,
      "ME114": 40,
      "ME115": 40
   }
}